1111111111111111111111111111
1000000000000000000000000001
1000000000000000000000000001
1001111111111001111111111001
1001000000000000000000001001
1001000000000000000000001001
1001001100111111110011001001
1001001000000000000001001001
1001001000000000000001001001
1001000001111001111000001001
1001000001000000001000001001
1001001001001001001001001001
1001001001001001001001001001
1000001000001001000001000001
1000001000001001000001000001
1001001001001001001001001001
1001001001001001001001001001
1001000001000000001000001001
1001000001111001111000001001
1001001000000000000001001001
1001001000000000000001001001
1001001100111111110011001001
1001000000000000000000001001
1001000000000000000000001001
1001111111111001111111111001
1000000000000000000000000001
1000000000000000000000000001
1111111111111111111111111111



  